1 0 0 1 4,1 50 0 1 4,1 100 0 1 4,1 150 0 1 4,1 200 0 1 4,1 250 0 1 4,1 300 0 1 4,1 350 0 1 4,1 400 0 1 4,1 450 0 1 4,1 500 0 1 4,1 550 0 1 4,1 600 0 1 4,1 650 0 1 4,1 700 0 1 4,1 750 0 1 4,1 800 0 1 4,1 850 0 1 4,1 900 0 1 4,1 950 0 1 4,1 1000 0 1 4,1 1050 0 1 4,1 1100 0 1 4,1 1150 0 1 4,1 1200 0 1 4,1 1250 0 1 4,1 1500 0 1 4,1 1550 0 1 4,1 1600 0 1 4,1 1650 0 1 4,1 1700 0 1 4,1 1750 0 1 4,1 1800 0 1 4,1 1850 0 1 4,1 1900 0 1 4,1 1950 0 1 4,1 2000 0 1 4,1 2050 0 1 4,1 2100 0 1 4,1 2150 0 1 4,1 2200 0 1 4,1 2250 0 1 4,1 2300 0 1 4,1 2350 0 1 4,1 2400 0 1 4,1 2450 0 1 4,1 2500 0 1 4,1 2550 0 1 4,1 2600 0 1 4,1 2650 0 1 4,1 2700 0 1 4,1 2750 0 1 4,0 3000 0 0 0,0 3050 0 0 0,0 3100 0 0 0,0 3150 0 0 0,0 3200 0 0 0,0 3250 0 0 0,0 3300 0 0 0,0 3350 0 0 0,0 3400 0 0 0,0 3450 0 0 0,0 3500 0 0 0,0 3550 0 0 0,0 3600 0 0 0,0 3650 0 0 0,0 3700 0 0 0,0 3750 0 0 0,0 3800 0 0 0,0 3850 0 0 0,0 3900 0 0 0,0 3950 0 0 0,0 4000 0 0 0,0 4050 0 0 0,0 4100 0 0 0,0 4150 0 0 0,0 4200 0 0 0,0 4250 0 0 0,0 4500 0 0 0,0 4550 0 0 0,0 4600 0 0 0,0 4650 0 0 0,0 4700 0 0 0,0 4750 0 0 0,0 4800 0 0 0,0 4850 0 0 0,0 4900 0 0 0,0 4950 0 0 0,0 5000 0 0 0,0 5050 0 0 0,0 5100 0 0 0,0 5150 0 0 0,0 5200 0 0 0,0 5250 0 0 0,0 5300 0 0 0,0 5350 0 0 0,0 5400 0 0 0,0 5450 0 0 0,0 5500 0 0 0,0 5550 0 0 0,0 5600 0 0 0,0 5650 0 0 0,0 5700 0 0 0,0 5750 0 0 0,0 6000 0 0 0,0 6050 0 0 0,0 6100 0 0 0,0 6150 0 0 0,0 6200 0 0 0,0 6250 0 0 0,0 6300 0 0 0,0 6350 0 0 0,0 6400 0 0 0,0 6450 0 0 0,0 6500 0 0 0,0 6550 0 0 0,0 6600 0 0 0,0 6650 0 0 0,0 6700 0 0 0,0 6750 0 0 0,0 6800 0 0 0,0 6850 0 0 0,0 6900 0 0 0,0 6950 0 0 0,0 7000 0 0 0,0 7050 0 0 0,0 7100 0 0 0,0 7150 0 0 0,0 7200 0 0 0,0 7250 0 0 0
1 0 50 1 3,1 50 50 1 3,1 100 50 1 3,1 150 50 1 3,1 200 50 2 3,0 250 50 0 0,0 300 50 0 0,0 350 50 0 0,0 400 50 0 0,0 450 50 0 0,0 500 50 0 0,0 550 50 0 0,0 600 50 0 0,0 650 50 0 0,0 700 50 0 0,0 750 50 0 0,0 800 50 0 0,1 850 50 3 2,0 900 50 0 0,0 950 50 0 0,0 1000 50 0 0,1 1050 50 3 2,0 1100 50 0 0,0 1150 50 0 0,0 1200 50 0 0,0 1250 50 0 0,0 1500 50 0 0,0 1550 50 0 0,0 1600 50 0 0,0 1650 50 0 0,0 1700 50 0 0,0 1750 50 0 0,0 1800 50 0 0,0 1850 50 0 0,0 1900 50 0 0,0 1950 50 0 0,0 2000 50 0 0,0 2050 50 0 0,0 2100 50 0 0,0 2150 50 0 0,0 2200 50 0 0,0 2250 50 0 0,0 2300 50 0 0,0 2350 50 0 0,0 2400 50 0 0,0 2450 50 0 0,0 2500 50 0 0,0 2550 50 0 0,0 2600 50 0 0,0 2650 50 0 0,0 2700 50 0 0,0 2750 50 0 0,0 3000 50 0 0,0 3050 50 0 0,0 3100 50 0 0,0 3150 50 0 0,0 3200 50 0 0,0 3250 50 0 0,0 3300 50 0 0,0 3350 50 0 0,0 3400 50 0 0,0 3450 50 0 0,0 3500 50 0 0,0 3550 50 0 0,0 3600 50 0 0,0 3650 50 0 0,0 3700 50 0 0,0 3750 50 0 0,0 3800 50 0 0,0 3850 50 0 0,0 3900 50 0 0,0 3950 50 0 0,0 4000 50 0 0,0 4050 50 0 0,0 4100 50 0 0,0 4150 50 0 0,0 4200 50 0 0,0 4250 50 0 0,0 4500 50 0 0,0 4550 50 0 0,0 4600 50 0 0,0 4650 50 0 0,0 4700 50 0 0,0 4750 50 0 0,0 4800 50 0 0,0 4850 50 0 0,0 4900 50 0 0,0 4950 50 0 0,0 5000 50 0 0,0 5050 50 0 0,0 5100 50 0 0,0 5150 50 0 0,0 5200 50 0 0,0 5250 50 0 0,0 5300 50 0 0,0 5350 50 0 0,0 5400 50 0 0,0 5450 50 0 0,0 5500 50 0 0,0 5550 50 0 0,0 5600 50 0 0,0 5650 50 0 0,0 5700 50 0 0,0 5750 50 0 0,0 6000 50 0 0,0 6050 50 0 0,0 6100 50 0 0,0 6150 50 0 0,0 6200 50 0 0,0 6250 50 0 0,0 6300 50 0 0,0 6350 50 0 0,0 6400 50 0 0,0 6450 50 0 0,0 6500 50 0 0,0 6550 50 0 0,0 6600 50 0 0,0 6650 50 0 0,0 6700 50 0 0,0 6750 50 0 0,0 6800 50 0 0,0 6850 50 0 0,0 6900 50 0 0,0 6950 50 0 0,0 7000 50 0 0,0 7050 50 0 0,0 7100 50 0 0,0 7150 50 0 0,0 7200 50 0 0,0 7250 50 0 0
1 0 100 1 3,1 50 100 1 3,1 100 100 1 3,1 150 100 1 3,1 200 100 2 3,0 250 100 0 0,0 300 100 0 0,0 350 100 0 0,0 400 100 0 0,0 450 100 0 0,0 500 100 0 0,0 550 100 0 0,0 600 100 0 0,0 650 100 0 0,0 700 100 0 0,0 750 100 0 0,0 800 100 0 0,1 850 100 3 3,0 900 100 0 0,0 950 100 0 0,0 1000 100 0 0,1 1050 100 3 3,0 1100 100 0 0,0 1150 100 0 0,0 1200 100 0 0,0 1250 100 0 0,0 1500 100 0 0,0 1550 100 0 0,0 1600 100 0 0,0 1650 100 0 0,0 1700 100 0 0,0 1750 100 0 0,0 1800 100 0 0,0 1850 100 0 0,0 1900 100 0 0,0 1950 100 0 0,0 2000 100 0 0,0 2050 100 0 0,0 2100 100 0 0,0 2150 100 0 0,0 2200 100 0 0,0 2250 100 0 0,0 2300 100 0 0,0 2350 100 0 0,0 2400 100 0 0,0 2450 100 0 0,0 2500 100 0 0,0 2550 100 0 0,0 2600 100 0 0,0 2650 100 0 0,0 2700 100 0 0,0 2750 100 0 0,0 3000 100 0 0,0 3050 100 0 0,0 3100 100 0 0,0 3150 100 0 0,0 3200 100 0 0,0 3250 100 0 0,0 3300 100 0 0,0 3350 100 0 0,0 3400 100 0 0,0 3450 100 0 0,0 3500 100 0 0,0 3550 100 0 0,0 3600 100 0 0,0 3650 100 0 0,0 3700 100 0 0,0 3750 100 0 0,0 3800 100 0 0,0 3850 100 0 0,0 3900 100 0 0,0 3950 100 0 0,0 4000 100 0 0,0 4050 100 0 0,0 4100 100 0 0,0 4150 100 0 0,0 4200 100 0 0,0 4250 100 0 0,0 4500 100 0 0,0 4550 100 0 0,0 4600 100 0 0,0 4650 100 0 0,0 4700 100 0 0,0 4750 100 0 0,0 4800 100 0 0,0 4850 100 0 0,0 4900 100 0 0,0 4950 100 0 0,0 5000 100 0 0,0 5050 100 0 0,0 5100 100 0 0,0 5150 100 0 0,0 5200 100 0 0,0 5250 100 0 0,0 5300 100 0 0,0 5350 100 0 0,0 5400 100 0 0,0 5450 100 0 0,0 5500 100 0 0,0 5550 100 0 0,0 5600 100 0 0,0 5650 100 0 0,0 5700 100 0 0,0 5750 100 0 0,0 6000 100 0 0,0 6050 100 0 0,0 6100 100 0 0,0 6150 100 0 0,0 6200 100 0 0,0 6250 100 0 0,0 6300 100 0 0,0 6350 100 0 0,0 6400 100 0 0,0 6450 100 0 0,0 6500 100 0 0,0 6550 100 0 0,0 6600 100 0 0,0 6650 100 0 0,0 6700 100 0 0,0 6750 100 0 0,0 6800 100 0 0,0 6850 100 0 0,0 6900 100 0 0,0 6950 100 0 0,0 7000 100 0 0,0 7050 100 0 0,0 7100 100 0 0,0 7150 100 0 0,0 7200 100 0 0,0 7250 100 0 0
1 0 150 1 4,1 50 150 1 4,1 100 150 1 4,1 150 150 1 4,1 200 150 2 4,0 250 150 0 0,0 300 150 0 0,0 350 150 0 0,0 400 150 0 0,1 450 150 0 2,1 500 150 2 2,0 550 150 0 0,0 600 150 0 0,0 650 150 0 0,0 700 150 0 0,0 750 150 0 0,0 800 150 0 0,1 850 150 3 3,0 900 150 0 0,0 950 150 0 0,0 1000 150 0 0,1 1050 150 3 3,0 1100 150 0 0,0 1150 150 0 0,0 1200 150 0 0,0 1250 150 0 0,0 1500 150 0 0,0 1550 150 0 0,0 1600 150 0 0,0 1650 150 0 0,0 1700 150 0 0,0 1750 150 0 0,0 1800 150 0 0,0 1850 150 0 0,0 1900 150 0 0,0 1950 150 0 0,0 2000 150 0 0,0 2050 150 0 0,0 2100 150 0 0,0 2150 150 0 0,0 2200 150 0 0,0 2250 150 0 0,0 2300 150 0 0,0 2350 150 0 0,0 2400 150 0 0,0 2450 150 0 0,0 2500 150 0 0,0 2550 150 0 0,0 2600 150 0 0,0 2650 150 0 0,0 2700 150 0 0,0 2750 150 0 0,0 3000 150 0 0,0 3050 150 0 0,0 3100 150 0 0,0 3150 150 0 0,0 3200 150 0 0,0 3250 150 0 0,0 3300 150 0 0,0 3350 150 0 0,0 3400 150 0 0,0 3450 150 0 0,0 3500 150 0 0,0 3550 150 0 0,0 3600 150 0 0,0 3650 150 0 0,0 3700 150 0 0,0 3750 150 0 0,0 3800 150 0 0,0 3850 150 0 0,0 3900 150 0 0,0 3950 150 0 0,0 4000 150 0 0,0 4050 150 0 0,0 4100 150 0 0,0 4150 150 0 0,0 4200 150 0 0,0 4250 150 0 0,0 4500 150 0 0,0 4550 150 0 0,0 4600 150 0 0,0 4650 150 0 0,0 4700 150 0 0,0 4750 150 0 0,0 4800 150 0 0,0 4850 150 0 0,0 4900 150 0 0,0 4950 150 0 0,0 5000 150 0 0,0 5050 150 0 0,0 5100 150 0 0,0 5150 150 0 0,0 5200 150 0 0,0 5250 150 0 0,0 5300 150 0 0,0 5350 150 0 0,0 5400 150 0 0,0 5450 150 0 0,0 5500 150 0 0,0 5550 150 0 0,0 5600 150 0 0,0 5650 150 0 0,0 5700 150 0 0,0 5750 150 0 0,0 6000 150 0 0,0 6050 150 0 0,0 6100 150 0 0,0 6150 150 0 0,0 6200 150 0 0,0 6250 150 0 0,0 6300 150 0 0,0 6350 150 0 0,0 6400 150 0 0,0 6450 150 0 0,0 6500 150 0 0,0 6550 150 0 0,0 6600 150 0 0,0 6650 150 0 0,0 6700 150 0 0,0 6750 150 0 0,0 6800 150 0 0,0 6850 150 0 0,0 6900 150 0 0,0 6950 150 0 0,0 7000 150 0 0,0 7050 150 0 0,0 7100 150 0 0,0 7150 150 0 0,0 7200 150 0 0,0 7250 150 0 0
0 0 200 0 0,0 50 200 0 0,0 100 200 0 0,0 150 200 0 0,0 200 200 0 0,0 250 200 0 0,0 300 200 0 0,0 350 200 0 0,0 400 200 0 0,1 450 200 0 3,1 500 200 2 3,0 550 200 0 0,0 600 200 0 0,0 650 200 0 0,0 700 200 0 0,0 750 200 0 0,0 800 200 0 0,1 850 200 3 4,0 900 200 0 0,0 950 200 0 0,0 1000 200 0 0,1 1050 200 3 3,0 1100 200 0 0,0 1150 200 0 0,0 1200 200 0 0,0 1250 200 0 0,0 1500 200 0 0,0 1550 200 0 0,0 1600 200 0 0,0 1650 200 0 0,0 1700 200 0 0,0 1750 200 0 0,0 1800 200 0 0,0 1850 200 0 0,0 1900 200 0 0,0 1950 200 0 0,0 2000 200 0 0,0 2050 200 0 0,0 2100 200 0 0,0 2150 200 0 0,0 2200 200 0 0,0 2250 200 0 0,0 2300 200 0 0,0 2350 200 0 0,0 2400 200 0 0,0 2450 200 0 0,0 2500 200 0 0,0 2550 200 0 0,0 2600 200 0 0,0 2650 200 0 0,0 2700 200 0 0,0 2750 200 0 0,0 3000 200 0 0,0 3050 200 0 0,0 3100 200 0 0,0 3150 200 0 0,0 3200 200 0 0,0 3250 200 0 0,0 3300 200 0 0,0 3350 200 0 0,0 3400 200 0 0,0 3450 200 0 0,0 3500 200 0 0,0 3550 200 0 0,0 3600 200 0 0,0 3650 200 0 0,0 3700 200 0 0,0 3750 200 0 0,0 3800 200 0 0,0 3850 200 0 0,0 3900 200 0 0,0 3950 200 0 0,0 4000 200 0 0,0 4050 200 0 0,0 4100 200 0 0,0 4150 200 0 0,0 4200 200 0 0,0 4250 200 0 0,0 4500 200 0 0,0 4550 200 0 0,0 4600 200 0 0,0 4650 200 0 0,0 4700 200 0 0,0 4750 200 0 0,0 4800 200 0 0,0 4850 200 0 0,0 4900 200 0 0,0 4950 200 0 0,0 5000 200 0 0,0 5050 200 0 0,0 5100 200 0 0,0 5150 200 0 0,0 5200 200 0 0,0 5250 200 0 0,0 5300 200 0 0,0 5350 200 0 0,0 5400 200 0 0,0 5450 200 0 0,0 5500 200 0 0,0 5550 200 0 0,0 5600 200 0 0,0 5650 200 0 0,0 5700 200 0 0,0 5750 200 0 0,0 6000 200 0 0,0 6050 200 0 0,0 6100 200 0 0,0 6150 200 0 0,0 6200 200 0 0,0 6250 200 0 0,0 6300 200 0 0,0 6350 200 0 0,0 6400 200 0 0,0 6450 200 0 0,0 6500 200 0 0,0 6550 200 0 0,0 6600 200 0 0,0 6650 200 0 0,0 6700 200 0 0,0 6750 200 0 0,0 6800 200 0 0,0 6850 200 0 0,0 6900 200 0 0,0 6950 200 0 0,0 7000 200 0 0,0 7050 200 0 0,0 7100 200 0 0,0 7150 200 0 0,0 7200 200 0 0,0 7250 200 0 0
0 0 250 0 0,0 50 250 0 0,0 100 250 0 0,0 150 250 0 0,0 200 250 0 0,0 250 250 0 0,0 300 250 0 0,0 350 250 0 0,0 400 250 0 0,1 450 250 0 3,1 500 250 2 3,1 550 250 2 2,0 600 250 0 0,0 650 250 0 0,0 700 250 0 0,0 750 250 0 0,0 800 250 0 0,0 850 250 0 0,0 900 250 0 0,0 950 250 0 0,0 1000 250 0 0,1 1050 250 3 3,0 1100 250 0 0,0 1150 250 0 0,0 1200 250 0 0,0 1250 250 0 0,0 1500 250 0 0,0 1550 250 0 0,0 1600 250 0 0,0 1650 250 0 0,0 1700 250 0 0,0 1750 250 0 0,0 1800 250 0 0,0 1850 250 0 0,0 1900 250 0 0,0 1950 250 0 0,0 2000 250 0 0,0 2050 250 0 0,0 2100 250 0 0,0 2150 250 0 0,0 2200 250 0 0,0 2250 250 0 0,0 2300 250 0 0,0 2350 250 0 0,0 2400 250 0 0,0 2450 250 0 0,0 2500 250 0 0,0 2550 250 0 0,0 2600 250 0 0,0 2650 250 0 0,0 2700 250 0 0,0 2750 250 0 0,0 3000 250 0 0,0 3050 250 0 0,0 3100 250 0 0,0 3150 250 0 0,0 3200 250 0 0,0 3250 250 0 0,0 3300 250 0 0,0 3350 250 0 0,0 3400 250 0 0,0 3450 250 0 0,0 3500 250 0 0,0 3550 250 0 0,0 3600 250 0 0,0 3650 250 0 0,0 3700 250 0 0,0 3750 250 0 0,0 3800 250 0 0,0 3850 250 0 0,0 3900 250 0 0,0 3950 250 0 0,0 4000 250 0 0,0 4050 250 0 0,0 4100 250 0 0,0 4150 250 0 0,0 4200 250 0 0,0 4250 250 0 0,0 4500 250 0 0,0 4550 250 0 0,0 4600 250 0 0,0 4650 250 0 0,0 4700 250 0 0,0 4750 250 0 0,0 4800 250 0 0,0 4850 250 0 0,0 4900 250 0 0,0 4950 250 0 0,0 5000 250 0 0,0 5050 250 0 0,0 5100 250 0 0,0 5150 250 0 0,0 5200 250 0 0,0 5250 250 0 0,0 5300 250 0 0,0 5350 250 0 0,0 5400 250 0 0,0 5450 250 0 0,0 5500 250 0 0,0 5550 250 0 0,0 5600 250 0 0,0 5650 250 0 0,0 5700 250 0 0,0 5750 250 0 0,0 6000 250 0 0,0 6050 250 0 0,0 6100 250 0 0,0 6150 250 0 0,0 6200 250 0 0,0 6250 250 0 0,0 6300 250 0 0,0 6350 250 0 0,0 6400 250 0 0,0 6450 250 0 0,0 6500 250 0 0,0 6550 250 0 0,0 6600 250 0 0,0 6650 250 0 0,0 6700 250 0 0,0 6750 250 0 0,0 6800 250 0 0,0 6850 250 0 0,0 6900 250 0 0,0 6950 250 0 0,0 7000 250 0 0,0 7050 250 0 0,0 7100 250 0 0,0 7150 250 0 0,0 7200 250 0 0,0 7250 250 0 0
0 0 300 0 0,0 50 300 0 0,0 100 300 0 0,0 150 300 0 0,0 200 300 0 0,0 250 300 0 0,0 300 300 0 0,0 350 300 0 0,0 400 300 0 0,1 450 300 0 3,1 500 300 2 3,1 550 300 2 4,0 600 300 0 0,0 650 300 0 0,0 700 300 0 0,0 750 300 0 0,0 800 300 0 0,0 850 300 0 0,0 900 300 0 0,0 950 300 0 0,0 1000 300 0 0,1 1050 300 3 3,0 1100 300 0 0,0 1150 300 0 0,0 1200 300 0 0,0 1250 300 0 0,0 1500 300 0 0,0 1550 300 0 0,0 1600 300 0 0,0 1650 300 0 0,0 1700 300 0 0,0 1750 300 0 0,0 1800 300 0 0,0 1850 300 0 0,0 1900 300 0 0,0 1950 300 0 0,0 2000 300 0 0,0 2050 300 0 0,0 2100 300 0 0,0 2150 300 0 0,0 2200 300 0 0,0 2250 300 0 0,0 2300 300 0 0,0 2350 300 0 0,0 2400 300 0 0,0 2450 300 0 0,0 2500 300 0 0,0 2550 300 0 0,0 2600 300 0 0,0 2650 300 0 0,0 2700 300 0 0,0 2750 300 0 0,0 3000 300 0 0,0 3050 300 0 0,0 3100 300 0 0,0 3150 300 0 0,0 3200 300 0 0,0 3250 300 0 0,0 3300 300 0 0,0 3350 300 0 0,0 3400 300 0 0,0 3450 300 0 0,0 3500 300 0 0,0 3550 300 0 0,0 3600 300 0 0,0 3650 300 0 0,0 3700 300 0 0,0 3750 300 0 0,0 3800 300 0 0,0 3850 300 0 0,0 3900 300 0 0,0 3950 300 0 0,0 4000 300 0 0,0 4050 300 0 0,0 4100 300 0 0,0 4150 300 0 0,0 4200 300 0 0,0 4250 300 0 0,0 4500 300 0 0,0 4550 300 0 0,0 4600 300 0 0,0 4650 300 0 0,0 4700 300 0 0,0 4750 300 0 0,0 4800 300 0 0,0 4850 300 0 0,0 4900 300 0 0,0 4950 300 0 0,0 5000 300 0 0,0 5050 300 0 0,0 5100 300 0 0,0 5150 300 0 0,0 5200 300 0 0,0 5250 300 0 0,0 5300 300 0 0,0 5350 300 0 0,0 5400 300 0 0,0 5450 300 0 0,0 5500 300 0 0,0 5550 300 0 0,0 5600 300 0 0,0 5650 300 0 0,0 5700 300 0 0,0 5750 300 0 0,0 6000 300 0 0,0 6050 300 0 0,0 6100 300 0 0,0 6150 300 0 0,0 6200 300 0 0,0 6250 300 0 0,0 6300 300 0 0,0 6350 300 0 0,0 6400 300 0 0,0 6450 300 0 0,0 6500 300 0 0,0 6550 300 0 0,0 6600 300 0 0,0 6650 300 0 0,0 6700 300 0 0,0 6750 300 0 0,0 6800 300 0 0,0 6850 300 0 0,0 6900 300 0 0,0 6950 300 0 0,0 7000 300 0 0,0 7050 300 0 0,0 7100 300 0 0,0 7150 300 0 0,0 7200 300 0 0,0 7250 300 0 0
0 0 350 0 0,0 50 350 0 0,0 100 350 0 0,0 150 350 0 0,0 200 350 0 0,0 250 350 0 0,0 300 350 0 0,0 350 350 0 0,0 400 350 0 0,1 450 350 0 4,1 500 350 2 4,0 550 350 0 0,0 600 350 0 0,0 650 350 0 0,1 700 350 3 2,0 750 350 0 0,0 800 350 0 0,0 850 350 0 0,0 900 350 0 0,0 950 350 0 0,0 1000 350 0 0,1 1050 350 3 4,0 1100 350 0 0,0 1150 350 0 0,0 1200 350 0 0,0 1250 350 0 0,0 1500 350 0 0,0 1550 350 0 0,0 1600 350 0 0,0 1650 350 0 0,0 1700 350 0 0,0 1750 350 0 0,0 1800 350 0 0,0 1850 350 0 0,0 1900 350 0 0,0 1950 350 0 0,0 2000 350 0 0,0 2050 350 0 0,0 2100 350 0 0,0 2150 350 0 0,0 2200 350 0 0,0 2250 350 0 0,0 2300 350 0 0,0 2350 350 0 0,0 2400 350 0 0,0 2450 350 0 0,0 2500 350 0 0,0 2550 350 0 0,0 2600 350 0 0,0 2650 350 0 0,0 2700 350 0 0,0 2750 350 0 0,0 3000 350 0 0,0 3050 350 0 0,0 3100 350 0 0,0 3150 350 0 0,0 3200 350 0 0,0 3250 350 0 0,0 3300 350 0 0,0 3350 350 0 0,0 3400 350 0 0,0 3450 350 0 0,0 3500 350 0 0,0 3550 350 0 0,0 3600 350 0 0,0 3650 350 0 0,0 3700 350 0 0,0 3750 350 0 0,0 3800 350 0 0,0 3850 350 0 0,0 3900 350 0 0,0 3950 350 0 0,0 4000 350 0 0,0 4050 350 0 0,0 4100 350 0 0,0 4150 350 0 0,0 4200 350 0 0,0 4250 350 0 0,0 4500 350 0 0,0 4550 350 0 0,0 4600 350 0 0,0 4650 350 0 0,0 4700 350 0 0,0 4750 350 0 0,0 4800 350 0 0,0 4850 350 0 0,0 4900 350 0 0,0 4950 350 0 0,0 5000 350 0 0,0 5050 350 0 0,0 5100 350 0 0,0 5150 350 0 0,0 5200 350 0 0,0 5250 350 0 0,0 5300 350 0 0,0 5350 350 0 0,0 5400 350 0 0,0 5450 350 0 0,0 5500 350 0 0,0 5550 350 0 0,0 5600 350 0 0,0 5650 350 0 0,0 5700 350 0 0,0 5750 350 0 0,0 6000 350 0 0,0 6050 350 0 0,0 6100 350 0 0,0 6150 350 0 0,0 6200 350 0 0,0 6250 350 0 0,0 6300 350 0 0,0 6350 350 0 0,0 6400 350 0 0,0 6450 350 0 0,0 6500 350 0 0,0 6550 350 0 0,0 6600 350 0 0,0 6650 350 0 0,0 6700 350 0 0,0 6750 350 0 0,0 6800 350 0 0,0 6850 350 0 0,0 6900 350 0 0,0 6950 350 0 0,0 7000 350 0 0,0 7050 350 0 0,0 7100 350 0 0,0 7150 350 0 0,0 7200 350 0 0,0 7250 350 0 0
0 0 400 0 0,0 50 400 0 0,0 100 400 0 0,0 150 400 0 0,0 200 400 0 0,0 250 400 0 0,0 300 400 0 0,0 350 400 0 0,0 400 400 0 0,0 450 400 0 0,0 500 400 0 0,0 550 400 0 0,0 600 400 0 0,0 650 400 0 0,1 700 400 3 3,0 750 400 0 0,0 800 400 0 0,0 850 400 0 0,0 900 400 0 0,0 950 400 0 0,0 1000 400 0 0,0 1050 400 0 0,0 1100 400 0 0,0 1150 400 0 0,0 1200 400 0 0,0 1250 400 0 0,0 1500 400 0 0,0 1550 400 0 0,0 1600 400 0 0,0 1650 400 0 0,0 1700 400 0 0,0 1750 400 0 0,0 1800 400 0 0,0 1850 400 0 0,0 1900 400 0 0,0 1950 400 0 0,0 2000 400 0 0,0 2050 400 0 0,0 2100 400 0 0,1 2150 400 0 2,1 2200 400 1 2,1 2250 400 1 2,1 2300 400 1 2,1 2350 400 1 2,1 2400 400 1 2,1 2450 400 1 2,1 2500 400 1 2,1 2550 400 2 2,0 2600 400 0 0,0 2650 400 0 0,0 2700 400 0 0,0 2750 400 0 0,0 3000 400 0 0,0 3050 400 0 0,0 3100 400 0 0,0 3150 400 0 0,0 3200 400 0 0,0 3250 400 0 0,0 3300 400 0 0,0 3350 400 0 0,0 3400 400 0 0,0 3450 400 0 0,0 3500 400 0 0,0 3550 400 0 0,0 3600 400 0 0,0 3650 400 0 0,0 3700 400 0 0,0 3750 400 0 0,0 3800 400 0 0,0 3850 400 0 0,0 3900 400 0 0,0 3950 400 0 0,0 4000 400 0 0,0 4050 400 0 0,0 4100 400 0 0,0 4150 400 0 0,0 4200 400 0 0,0 4250 400 0 0,0 4500 400 0 0,0 4550 400 0 0,0 4600 400 0 0,0 4650 400 0 0,0 4700 400 0 0,0 4750 400 0 0,0 4800 400 0 0,0 4850 400 0 0,0 4900 400 0 0,0 4950 400 0 0,0 5000 400 0 0,0 5050 400 0 0,0 5100 400 0 0,0 5150 400 0 0,0 5200 400 0 0,0 5250 400 0 0,0 5300 400 0 0,0 5350 400 0 0,0 5400 400 0 0,0 5450 400 0 0,0 5500 400 0 0,0 5550 400 0 0,0 5600 400 0 0,0 5650 400 0 0,0 5700 400 0 0,0 5750 400 0 0,0 6000 400 0 0,0 6050 400 0 0,0 6100 400 0 0,0 6150 400 0 0,0 6200 400 0 0,0 6250 400 0 0,0 6300 400 0 0,0 6350 400 0 0,0 6400 400 0 0,0 6450 400 0 0,0 6500 400 0 0,0 6550 400 0 0,0 6600 400 0 0,0 6650 400 0 0,0 6700 400 0 0,0 6750 400 0 0,0 6800 400 0 0,0 6850 400 0 0,0 6900 400 0 0,0 6950 400 0 0,0 7000 400 0 0,0 7050 400 0 0,0 7100 400 0 0,0 7150 400 0 0,0 7200 400 0 0,0 7250 400 0 0
0 0 450 0 0,0 50 450 0 0,0 100 450 0 0,0 150 450 0 0,0 200 450 0 0,0 250 450 0 0,0 300 450 0 0,0 350 450 0 0,0 400 450 0 0,0 450 450 0 0,0 500 450 0 0,0 550 450 0 0,0 600 450 0 0,0 650 450 0 0,1 700 450 3 3,0 750 450 0 0,0 800 450 0 0,0 850 450 0 0,0 900 450 0 0,0 950 450 0 0,0 1000 450 0 0,0 1050 450 0 0,0 1100 450 0 0,0 1150 450 0 0,0 1200 450 0 0,0 1250 450 0 0,0 1500 450 0 0,0 1550 450 0 0,0 1600 450 0 0,1 1650 450 0 2,1 1700 450 1 2,1 1750 450 1 2,1 1800 450 1 2,1 1850 450 2 2,0 1900 450 0 0,0 1950 450 0 0,0 2000 450 0 0,0 2050 450 0 0,0 2100 450 0 0,1 2150 450 0 3,1 2200 450 1 3,1 2250 450 1 3,1 2300 450 1 3,1 2350 450 1 3,1 2400 450 1 3,1 2450 450 1 3,1 2500 450 1 3,1 2550 450 2 3,0 2600 450 0 0,0 2650 450 0 0,0 2700 450 0 0,0 2750 450 0 0,0 3000 450 0 0,0 3050 450 0 0,0 3100 450 0 0,0 3150 450 0 0,0 3200 450 0 0,0 3250 450 0 0,0 3300 450 0 0,0 3350 450 0 0,0 3400 450 0 0,0 3450 450 0 0,0 3500 450 0 0,0 3550 450 0 0,0 3600 450 0 0,0 3650 450 0 0,0 3700 450 0 0,0 3750 450 0 0,0 3800 450 0 0,0 3850 450 0 0,0 3900 450 0 0,0 3950 450 0 0,0 4000 450 0 0,0 4050 450 0 0,0 4100 450 0 0,0 4150 450 0 0,0 4200 450 0 0,0 4250 450 0 0,0 4500 450 0 0,0 4550 450 0 0,0 4600 450 0 0,0 4650 450 0 0,0 4700 450 0 0,0 4750 450 0 0,0 4800 450 0 0,0 4850 450 0 0,0 4900 450 0 0,0 4950 450 0 0,0 5000 450 0 0,0 5050 450 0 0,0 5100 450 0 0,0 5150 450 0 0,0 5200 450 0 0,0 5250 450 0 0,0 5300 450 0 0,0 5350 450 0 0,0 5400 450 0 0,0 5450 450 0 0,0 5500 450 0 0,0 5550 450 0 0,0 5600 450 0 0,0 5650 450 0 0,0 5700 450 0 0,0 5750 450 0 0,0 6000 450 0 0,0 6050 450 0 0,0 6100 450 0 0,0 6150 450 0 0,0 6200 450 0 0,0 6250 450 0 0,0 6300 450 0 0,0 6350 450 0 0,0 6400 450 0 0,0 6450 450 0 0,0 6500 450 0 0,0 6550 450 0 0,0 6600 450 0 0,0 6650 450 0 0,0 6700 450 0 0,0 6750 450 0 0,0 6800 450 0 0,0 6850 450 0 0,0 6900 450 0 0,0 6950 450 0 0,0 7000 450 0 0,0 7050 450 0 0,0 7100 450 0 0,0 7150 450 0 0,0 7200 450 0 0,0 7250 450 0 0
0 0 500 0 0,0 50 500 0 0,0 100 500 0 0,0 150 500 0 0,0 200 500 0 0,0 250 500 0 0,0 300 500 0 0,0 350 500 0 0,1 400 500 0 2,1 450 500 1 2,1 500 500 1 2,1 550 500 2 2,0 600 500 0 0,0 650 500 0 0,1 700 500 3 3,1 750 500 3 2,0 800 500 0 0,0 850 500 0 0,0 900 500 0 0,0 950 500 0 0,0 1000 500 0 0,0 1050 500 0 0,0 1100 500 0 0,0 1150 500 0 0,0 1200 500 0 0,0 1250 500 0 0,0 1500 500 0 0,0 1550 500 0 0,0 1600 500 0 0,1 1650 500 0 3,1 1700 500 1 3,1 1750 500 1 3,1 1800 500 1 3,1 1850 500 2 3,0 1900 500 0 0,0 1950 500 0 0,0 2000 500 0 0,0 2050 500 0 0,0 2100 500 0 0,1 2150 500 0 3,1 2200 500 1 3,1 2250 500 1 3,1 2300 500 1 3,1 2350 500 1 3,1 2400 500 1 3,1 2450 500 1 3,1 2500 500 1 3,1 2550 500 2 3,0 2600 500 0 0,0 2650 500 0 0,0 2700 500 0 0,0 2750 500 0 0,0 3000 500 0 0,0 3050 500 0 0,0 3100 500 0 0,0 3150 500 0 0,0 3200 500 0 0,0 3250 500 0 0,0 3300 500 0 0,0 3350 500 0 0,0 3400 500 0 0,0 3450 500 0 0,0 3500 500 0 0,0 3550 500 0 0,0 3600 500 0 0,0 3650 500 0 0,0 3700 500 0 0,0 3750 500 0 0,0 3800 500 0 0,0 3850 500 0 0,0 3900 500 0 0,0 3950 500 0 0,0 4000 500 0 0,0 4050 500 0 0,0 4100 500 0 0,0 4150 500 0 0,0 4200 500 0 0,0 4250 500 0 0,0 4500 500 0 0,0 4550 500 0 0,0 4600 500 0 0,0 4650 500 0 0,0 4700 500 0 0,0 4750 500 0 0,0 4800 500 0 0,0 4850 500 0 0,0 4900 500 0 0,0 4950 500 0 0,0 5000 500 0 0,0 5050 500 0 0,0 5100 500 0 0,0 5150 500 0 0,0 5200 500 0 0,0 5250 500 0 0,0 5300 500 0 0,0 5350 500 0 0,0 5400 500 0 0,0 5450 500 0 0,0 5500 500 0 0,0 5550 500 0 0,0 5600 500 0 0,0 5650 500 0 0,0 5700 500 0 0,0 5750 500 0 0,0 6000 500 0 0,0 6050 500 0 0,0 6100 500 0 0,0 6150 500 0 0,0 6200 500 0 0,0 6250 500 0 0,0 6300 500 0 0,0 6350 500 0 0,0 6400 500 0 0,0 6450 500 0 0,0 6500 500 0 0,0 6550 500 0 0,0 6600 500 0 0,0 6650 500 0 0,0 6700 500 0 0,0 6750 500 0 0,0 6800 500 0 0,0 6850 500 0 0,0 6900 500 0 0,0 6950 500 0 0,0 7000 500 0 0,0 7050 500 0 0,0 7100 500 0 0,0 7150 500 0 0,0 7200 500 0 0,0 7250 500 0 0
1 0 550 1 2,1 50 550 1 2,1 100 550 1 2,1 150 550 1 2,1 200 550 1 2,1 250 550 2 2,0 300 550 0 0,0 350 550 0 0,1 400 550 0 3,1 450 550 1 3,1 500 550 1 3,1 550 550 2 3,0 600 550 0 0,0 650 550 0 0,1 700 550 3 3,1 750 550 3 3,1 800 550 1 2,1 850 550 1 2,1 900 550 2 2,0 950 550 0 0,0 1000 550 0 0,1 1050 550 0 5,1 1100 550 1 5,1 1150 550 1 5,1 1200 550 1 5,1 1250 550 1 5,1 1500 550 3 5,0 1550 550 0 0,0 1600 550 0 0,1 1650 550 0 3,1 1700 550 1 3,1 1750 550 1 3,1 1800 550 1 3,1 1850 550 2 3,0 1900 550 0 0,0 1950 550 0 0,0 2000 550 0 0,1 2050 550 0 2,1 2100 550 1 2,1 2150 550 0 3,1 2200 550 1 3,1 2250 550 1 3,1 2300 550 1 3,1 2350 550 1 3,1 2400 550 1 3,1 2450 550 1 3,1 2500 550 1 3,1 2550 550 2 3,0 2600 550 0 0,0 2650 550 0 0,0 2700 550 0 0,0 2750 550 0 0,0 3000 550 0 0,0 3050 550 0 0,0 3100 550 0 0,0 3150 550 0 0,0 3200 550 0 0,0 3250 550 0 0,0 3300 550 0 0,0 3350 550 0 0,0 3400 550 0 0,0 3450 550 0 0,0 3500 550 0 0,0 3550 550 0 0,0 3600 550 0 0,0 3650 550 0 0,0 3700 550 0 0,0 3750 550 0 0,0 3800 550 0 0,0 3850 550 0 0,0 3900 550 0 0,0 3950 550 0 0,0 4000 550 0 0,0 4050 550 0 0,0 4100 550 0 0,0 4150 550 0 0,0 4200 550 0 0,0 4250 550 0 0,0 4500 550 0 0,0 4550 550 0 0,0 4600 550 0 0,0 4650 550 0 0,0 4700 550 0 0,0 4750 550 0 0,0 4800 550 0 0,0 4850 550 0 0,0 4900 550 0 0,0 4950 550 0 0,0 5000 550 0 0,0 5050 550 0 0,0 5100 550 0 0,0 5150 550 0 0,0 5200 550 0 0,0 5250 550 0 0,0 5300 550 0 0,0 5350 550 0 0,0 5400 550 0 0,0 5450 550 0 0,0 5500 550 0 0,0 5550 550 0 0,0 5600 550 0 0,0 5650 550 0 0,0 5700 550 0 0,0 5750 550 0 0,0 6000 550 0 0,0 6050 550 0 0,0 6100 550 0 0,0 6150 550 0 0,0 6200 550 0 0,0 6250 550 0 0,0 6300 550 0 0,0 6350 550 0 0,0 6400 550 0 0,0 6450 550 0 0,0 6500 550 0 0,0 6550 550 0 0,0 6600 550 0 0,0 6650 550 0 0,0 6700 550 0 0,0 6750 550 0 0,0 6800 550 0 0,0 6850 550 0 0,0 6900 550 0 0,0 6950 550 0 0,0 7000 550 0 0,0 7050 550 0 0,0 7100 550 0 0,0 7150 550 0 0,0 7200 550 0 0,0 7250 550 0 0
1 0 600 1 3,1 50 600 1 3,1 100 600 1 3,1 150 600 1 3,1 200 600 1 3,1 250 600 2 3,0 300 600 0 0,0 350 600 0 0,1 400 600 0 3,1 450 600 1 3,1 500 600 1 3,1 550 600 2 3,0 600 600 0 0,0 650 600 0 0,1 700 600 3 3,1 750 600 3 3,1 800 600 1 3,1 850 600 1 3,1 900 600 2 3,0 950 600 0 0,0 1000 600 0 0,1 1050 600 0 6,1 1100 600 1 6,1 1150 600 2 6,1 1200 600 2 6,1 1250 600 2 6,1 1500 600 3 6,0 1550 600 0 0,0 1600 600 0 0,1 1650 600 0 3,1 1700 600 1 3,1 1750 600 1 3,1 1800 600 1 3,1 1850 600 2 3,0 1900 600 0 0,0 1950 600 0 0,0 2000 600 0 0,1 2050 600 0 3,1 2100 600 1 3,1 2150 600 0 3,1 2200 600 1 3,1 2250 600 1 3,1 2300 600 1 3,1 2350 600 1 3,1 2400 600 1 3,1 2450 600 1 3,1 2500 600 1 3,1 2550 600 2 3,0 2600 600 0 0,0 2650 600 0 0,0 2700 600 0 0,0 2750 600 0 0,0 3000 600 0 0,0 3050 600 0 0,0 3100 600 0 0,0 3150 600 0 0,0 3200 600 0 0,0 3250 600 0 0,0 3300 600 0 0,0 3350 600 0 0,0 3400 600 0 0,0 3450 600 0 0,0 3500 600 0 0,0 3550 600 0 0,0 3600 600 0 0,0 3650 600 0 0,0 3700 600 0 0,0 3750 600 0 0,0 3800 600 0 0,0 3850 600 0 0,0 3900 600 0 0,0 3950 600 0 0,0 4000 600 0 0,0 4050 600 0 0,0 4100 600 0 0,0 4150 600 0 0,0 4200 600 0 0,0 4250 600 0 0,0 4500 600 0 0,0 4550 600 0 0,0 4600 600 0 0,0 4650 600 0 0,0 4700 600 0 0,0 4750 600 0 0,0 4800 600 0 0,0 4850 600 0 0,0 4900 600 0 0,0 4950 600 0 0,0 5000 600 0 0,0 5050 600 0 0,0 5100 600 0 0,0 5150 600 0 0,0 5200 600 0 0,0 5250 600 0 0,0 5300 600 0 0,0 5350 600 0 0,0 5400 600 0 0,0 5450 600 0 0,0 5500 600 0 0,0 5550 600 0 0,0 5600 600 0 0,0 5650 600 0 0,0 5700 600 0 0,0 5750 600 0 0,0 6000 600 0 0,0 6050 600 0 0,0 6100 600 0 0,0 6150 600 0 0,0 6200 600 0 0,0 6250 600 0 0,0 6300 600 0 0,0 6350 600 0 0,0 6400 600 0 0,0 6450 600 0 0,0 6500 600 0 0,0 6550 600 0 0,0 6600 600 0 0,0 6650 600 0 0,0 6700 600 0 0,0 6750 600 0 0,0 6800 600 0 0,0 6850 600 0 0,0 6900 600 0 0,0 6950 600 0 0,0 7000 600 0 0,0 7050 600 0 0,0 7100 600 0 0,0 7150 600 0 0,0 7200 600 0 0,0 7250 600 0 0
1 0 650 1 3,1 50 650 1 3,1 100 650 1 3,1 150 650 1 3,1 200 650 1 3,1 250 650 2 3,0 300 650 0 0,0 350 650 0 0,1 400 650 0 3,1 450 650 1 3,1 500 650 1 3,1 550 650 2 3,0 600 650 0 0,0 650 650 0 0,1 700 650 3 3,1 750 650 3 3,1 800 650 1 3,1 850 650 1 3,1 900 650 2 3,0 950 650 0 0,0 1000 650 0 0,1 1050 650 0 6,1 1100 650 2 6,1 1150 650 2 6,1 1200 650 2 6,1 1250 650 2 6,1 1500 650 3 6,0 1550 650 0 0,0 1600 650 0 0,1 1650 650 0 3,1 1700 650 1 3,1 1750 650 1 3,1 1800 650 1 3,1 1850 650 2 3,0 1900 650 0 0,0 1950 650 0 0,0 2000 650 0 0,1 2050 650 0 3,1 2100 650 1 3,1 2150 650 0 3,1 2200 650 1 3,1 2250 650 1 3,1 2300 650 1 3,1 2350 650 1 3,1 2400 650 1 3,1 2450 650 1 3,1 2500 650 1 3,1 2550 650 2 3,0 2600 650 0 0,0 2650 650 0 0,0 2700 650 0 0,0 2750 650 0 0,0 3000 650 0 0,0 3050 650 0 0,0 3100 650 0 0,0 3150 650 0 0,0 3200 650 0 0,0 3250 650 0 0,0 3300 650 0 0,0 3350 650 0 0,0 3400 650 0 0,0 3450 650 0 0,0 3500 650 0 0,0 3550 650 0 0,0 3600 650 0 0,0 3650 650 0 0,0 3700 650 0 0,0 3750 650 0 0,0 3800 650 0 0,0 3850 650 0 0,0 3900 650 0 0,0 3950 650 0 0,0 4000 650 0 0,0 4050 650 0 0,0 4100 650 0 0,0 4150 650 0 0,0 4200 650 0 0,0 4250 650 0 0,0 4500 650 0 0,0 4550 650 0 0,0 4600 650 0 0,0 4650 650 0 0,0 4700 650 0 0,0 4750 650 0 0,0 4800 650 0 0,0 4850 650 0 0,0 4900 650 0 0,0 4950 650 0 0,0 5000 650 0 0,0 5050 650 0 0,0 5100 650 0 0,0 5150 650 0 0,0 5200 650 0 0,0 5250 650 0 0,0 5300 650 0 0,0 5350 650 0 0,0 5400 650 0 0,0 5450 650 0 0,0 5500 650 0 0,0 5550 650 0 0,0 5600 650 0 0,0 5650 650 0 0,0 5700 650 0 0,0 5750 650 0 0,0 6000 650 0 0,0 6050 650 0 0,0 6100 650 0 0,0 6150 650 0 0,0 6200 650 0 0,0 6250 650 0 0,0 6300 650 0 0,0 6350 650 0 0,0 6400 650 0 0,0 6450 650 0 0,0 6500 650 0 0,0 6550 650 0 0,0 6600 650 0 0,0 6650 650 0 0,0 6700 650 0 0,0 6750 650 0 0,0 6800 650 0 0,0 6850 650 0 0,0 6900 650 0 0,0 6950 650 0 0,0 7000 650 0 0,0 7050 650 0 0,0 7100 650 0 0,0 7150 650 0 0,0 7200 650 0 0,0 7250 650 0 0
1 0 700 1 3,1 50 700 1 3,1 100 700 1 3,1 150 700 1 3,1 200 700 1 3,1 250 700 2 3,0 300 700 0 0,0 350 700 0 0,1 400 700 0 3,1 450 700 1 3,1 500 700 1 3,1 550 700 2 3,0 600 700 0 0,0 650 700 0 0,1 700 700 3 4,1 750 700 3 4,1 800 700 1 3,1 850 700 1 3,1 900 700 2 3,0 950 700 0 0,0 1000 700 0 0,1 1050 700 0 6,1 1100 700 2 6,1 1150 700 2 6,1 1200 700 2 6,1 1250 700 2 6,1 1500 700 3 6,0 1550 700 0 0,0 1600 700 0 0,1 1650 700 0 3,1 1700 700 1 3,1 1750 700 1 3,1 1800 700 1 3,1 1850 700 2 3,0 1900 700 0 0,0 1950 700 0 0,0 2000 700 0 0,1 2050 700 0 3,1 2100 700 1 3,1 2150 700 0 3,1 2200 700 1 3,1 2250 700 1 3,1 2300 700 1 3,1 2350 700 1 3,1 2400 700 1 3,1 2450 700 1 3,1 2500 700 1 3,1 2550 700 2 3,0 2600 700 0 0,0 2650 700 0 0,0 2700 700 0 0,0 2750 700 0 0,0 3000 700 0 0,0 3050 700 0 0,0 3100 700 0 0,0 3150 700 0 0,0 3200 700 0 0,0 3250 700 0 0,0 3300 700 0 0,0 3350 700 0 0,0 3400 700 0 0,0 3450 700 0 0,0 3500 700 0 0,0 3550 700 0 0,0 3600 700 0 0,0 3650 700 0 0,0 3700 700 0 0,0 3750 700 0 0,0 3800 700 0 0,0 3850 700 0 0,0 3900 700 0 0,0 3950 700 0 0,0 4000 700 0 0,0 4050 700 0 0,0 4100 700 0 0,0 4150 700 0 0,0 4200 700 0 0,0 4250 700 0 0,0 4500 700 0 0,0 4550 700 0 0,0 4600 700 0 0,0 4650 700 0 0,0 4700 700 0 0,0 4750 700 0 0,0 4800 700 0 0,0 4850 700 0 0,0 4900 700 0 0,0 4950 700 0 0,0 5000 700 0 0,0 5050 700 0 0,0 5100 700 0 0,0 5150 700 0 0,0 5200 700 0 0,0 5250 700 0 0,0 5300 700 0 0,0 5350 700 0 0,0 5400 700 0 0,0 5450 700 0 0,0 5500 700 0 0,0 5550 700 0 0,0 5600 700 0 0,0 5650 700 0 0,0 5700 700 0 0,0 5750 700 0 0,0 6000 700 0 0,0 6050 700 0 0,0 6100 700 0 0,0 6150 700 0 0,0 6200 700 0 0,0 6250 700 0 0,0 6300 700 0 0,0 6350 700 0 0,0 6400 700 0 0,0 6450 700 0 0,0 6500 700 0 0,0 6550 700 0 0,0 6600 700 0 0,0 6650 700 0 0,0 6700 700 0 0,0 6750 700 0 0,0 6800 700 0 0,0 6850 700 0 0,0 6900 700 0 0,0 6950 700 0 0,0 7000 700 0 0,0 7050 700 0 0,0 7100 700 0 0,0 7150 700 0 0,0 7200 700 0 0,0 7250 700 0 0